overslaan			skip
onderbreking			interruption
uitbarsting			eruption
enkelvoud			singular		
meervoud    			plural	
meervoudsvormen		plurals	
meerdere			several
werkwoord			verb
onregelmatige werkwoorden	irregular verbs
bijwoord			adverb	
bijvoeglijk naamwoord		adjective
zelfstandig naamwoord		noun
voornaamwoord		pronoun
uitspreken			to pronounce
voegwoord			conjunction	
voltooid deelwoord		past participle	
helemaal/geheel regelmatig	entirely regular
rok, hemd, jas, jurk, pak	skirt, shirt, coat, dress, suit
grijs, bruin, wit, geel, paars	gray, brown, white, yellow, purple
kleur, kleurrijk			color, colorful
broek				pants
vraag, antwoord		question, answer
seizoen				season
leeftijd				age
maand				month
klein beetje			little bit
stukje, beetje			bit
stuk, stukje			piece
meerderjarig			of ace
tante, tantes, oom		aunt, aunts, uncle
mier				ant
broer en zus			sibling
broers en zussen		siblings
tweeling			twin
ober, serveerster		waiter, waitress
directeur, regisseur		director
personeel			staff
bewaker			guard
beroep				profession
secretaris, secretaresse	secretary
op het werk			at work
olie				oil
ontbijt				breakfast
handig				convenient, useful (op verschillende manieren te gebruiken)
nuttig/nutteloos		useful/useless
afhankelijk			dependent
onafhankelijk/zelfstandig	independent
onafhankelijkheid		independence
tegenover			opposite
gemiddelde			average
meerderheid			majority
burgemeester			mayor
avontuur			adventure
avonturier			adventurer
comité				committee
individu				individual
iemand				somebody, someone, anybody, anyone
iedereen			everybody, everyone, anybody, anyone 
elk, ieder			any, each, every
iemand anders			someone else
niemand			nobody, no one
iets				something 
elk iets				anything
alles				everything, anything
allesbehalve			anything but
niets				nothing
samen				together
ergens				somewhere
overal				everywhere, anywhere
nergens			nowhere
hele, gehele			entire (geheel zoals gehele boek/wagenpark), whole (enkel object)
alleen				alone (fysiek)
eenzaam			lonely (emotioneel), lonesome
samen				together
dit				this
deze				these
dat				that
die				those	
wat				what
alleen maar, enkel en alleen	only, just, merely
net				just				
één keer			once
beide				both
elkaar				each other 
elk ander			any other
ander				other
een andere, nog een		another
zulk, zo een			such
zoiets				such a thing
alle anderen/elk ander		everybody else/ any other
echter, maar, toch		however
in ieder geval, sowieso		anyway, in any case
hoe dan ook			anyhow	
wat dan ook			whatever
waar dan ook, overal waar	wherever
overal				everywhere, anywhere
tenminste			at least
minst				least
beschikbaar			available
niet beschikbaar		unavailable
efficiënt			efficient, efficiently
negatief			negative
professionele acteur		professional actor		
officieel diner			official dinner
officiële kleuren		official colors
persoonlijk			personal
speciaal			special
verantwoordelijk		responsible
verantwoordelijkheid		responsibility	
erg, ernstig			serious (BN), seriously (BW)
historisch			historical
culturele weken		cultural weeks
traditionele familie		traditional family
godsdienstige schrijver		religious writer
gelovig 			religious
populair			popular
bekend				familiar (bij iemand bekend), known (bij velen bekend)
onbekend			unknown
definitie			definition
definitief			definite
beslist, absoluut		definitely
compleet			complete (zoals een puzzle)		
volstrekt, volkomen, helemaal	completely 
volkomen, in de ruimste mate	utterly
perfect, volstrekt, heel goed	perfectly
belangrijk			important
voornaamste			main
hoofdzaak			main thing
voornamelijk, hoofdzakelijk	mainly
noodzakelijk			necessary
per se, noodzakelijkerwijs	necessarily
nog, toch			yet
zelfs				even
altijd				always
voor altijd			forever
ooit				ever
nooit				never
mooi, best			pretty
reden				reason
behoorlijk, redelijk		reasonable (BN), reasonably(BW), quite
nogal				quite
rustig, kalm, stil		calm (persoon), quiet (omgeving)
stilte				silence (volledig stille omgeving)
liever, eerder			rather 
nogal				rather (meer dan verwacht) quite (legt minder nadruk)
liever dan, eerder dan		rather than
dan				then, than (vergelijking met)
hier 				here
daar, er			there
ook				also, too, either (wordt gebruikt in negatieve zinnen)
ongeveer			approximately
straks, later			later
meestal, gewoonlijk		usually
grotendeels			mostly
in het algemeen		in general, generally
makkelijk, gemakkelijk		easy
vooral, speciaal, met name	especially	
helder, duidelijk		clear
toren				tower
boerderij, boer			farm, farmer
dorp				village
plaats, stad			town
stad				city
eiland				island
paleis				palace
adres				address
bioscoop			cinema
paraplu				umbrella
melkpoeder			milk powder
roman				novel
kam				comb
dak, wortel			roof, root
zeep				soap
wiel, stuur			wheel
mensen			people, humans
menselijk			human
mens				human being 
mensheid			humanity
stel, paar, koppel		couple
paar				pair
bevolking, populatie		population
slachtoffer			victim
rollende dobbelsteen		tumbling dice
vlag				flag
schaar				scissors
jeugd				youth
rugzak				backpack
motor				motorcycle
voertuig			vehicle
tijdschrift			magazine
reis				trip, journey
toerist				tourist
geen				none
honderd			a hundred
som				sum
bibliotheek			library
voorbeeld			example
monster			sample
uitvoering, optreden		performance
in aanbouw			under construction
bouw, constructie		construction
slecht				bad	
slechter, erger			worse
slechtst, ergst			worst
eerder				previous, previously
antwoord, reactie		response
probleem, kwestie		issue
geval, zaak			case 
materie, zaak, kwestie		matter
oorzaak, zaak			cause
geval, instantie, voorbeeld	instance
ervaring			experience
twijfel				doubt
vergunning			permit, license
toestemming			permission
in vorm				in shape
poging				attempt
inspanning, moeite		effort
belang				interest, importance
interessant			interesting
geïnteresseerd			interested
welk				which, what
welke				which one
wiens, van wie			whose
mezelf, jezelf, onszelf		myself, yourself, ourselves
zichzelf				himself, herself, itself, themselves
jullie zelf			yourselves
rook				smoke
blad, bladeren			leaf, leaves
zon, maan, ster		sun, moon, star
gewas				crop
regio				region
bos				woods, forest
berg				mountain
lente, zomer, herfst, winter	spring, summer, fall, winter
maandag, dinsdag, woensdag	Monday Tuesday Wednesday
donderdag, vrijdag		Thursday Friday
zaterdag, zondag		Saturday Sunday
januari, februari, maart	January February March
april, mei, juni, juli		April May June July
augustus, september		August September
oktober, november, december	October November December	
echt				real
pad				path
geluk				joy
geniet ervan			enjoy it
eer				honor
plezier				fun
grappig				funny
genoegen,welbehagen,plezier	pleasure
gunst				favor
bang				afraid, scared
bange				frightened
enge				scary
angst				fear
woede				anger
vertrouwen, geloof		faith (op gevoel)
vertrouwen			confidence (ZNW)
zelfverzekerd, vol vertrouwen	confident (BNW)
comfort				comfort
comfortabel			comfortable
comfortabel gevoelloos		comfortably numb (verdoofd)
gedachtenbeheersing		thought control
speelgoed			toys
spel				game
wedstrijd			contest, match
inhoud				content
scheidsrechter			referee
kampioenschap			championship
sportschool			gym
atleet				athlete
doel				aim, purpose, goal
doelstelling			objective
voorwerp			object
onderwerp			subject
tekort				lack
meer				lake
viool, fluit			violin, flute
verzameling, collectie		collection
muziekcarrière			musical career
muziekinstrument		musical instrument
muzieknoot			musical note
musical				musical
postzegel			stamp
oog, mond, hersenen		eye, mouth, brain
zicht				sight, vision, view
advies				advice
legaal				legal
leider				leader
congres				congress
de fout, de schuld		fault, blame
fout, vergissing			mistake
schuld(geld)			debt
hoeveelheid,bedrag,aantal	amount
kwaliteit			quality
kwantiteit, hoeveelheid		quantity
kosten				cost, costs
lading				load
kosten, lading			charge
onderzoek			study, investigation, research
de samenleving		the society
resultaat			result
effect				effect
gevolg, consequentie		consequence
volgorde			sequence
het geweten			the conscience
commentaar			comment
opmerkingen			comments
aantekening, notitie		note
verkiezing(en)			election(s)
kiezer				voter
wetenschap			science
wetenschapper			scientist
wetenschappelijk		scientific
laboratorium			laboratory
stip				dot
vermeerdering, toename	increase
vermindering, afname		decrease
methode			method
cyclus, kringloop		cycle
merk				brand
geldeenheid, valuta		currency
tegenwoordig, momenteel	currently, at the moment
reclame			advertising
advertentie			advertisement
organisatie			organization
wettelijke kosten		legal costs
tweetalig			bilingual
taalkunde			linguistics
geografie, aardrijkskunde	geography
natuurkunde			physics
scheikunde			chemistry
wiskunde			math, mathematics
biologie				biology
geneeskunde			medicine
technologie			technology
techniek			technique
technische			technical
technische universiteit		university, university of technology
filosofie				philosophy
sociologie			sociology
psychologie			psychology
fysiotherapie			physiotherapy	
fysiek				physical
internationaal recht		international law
fotografie			photography
formule				formula
volume				volume
diepte				depth
lengte, duur			length
hoogte				height
ondernemer			entrepreneur
het bedrijf			the company, the business
gezelschap			company
zakenman, zakenvrouw	businessman, businesswoman
de firma			the firm
fabriek				factory
stichting			foundation
eigenaar (ook baasje hond)	owner
baas				boss
rekening, cheque		check (vs voor rekening), bill (Engels voor rekening)
het kost tijd			it takes time, it costs time
mondiaal, wereldwijd		global
globalisering			globalization
maatregel, maat, maatstaf	measure
meeteenheid, afmeting		measure
prijs				price (geld dat je betaald bij aankoop)
prijs				prize (prijs die je in een competitie wint), award
waard				worth (is het dit waard)
waardeloos			worthless
waarde, prijs			value (wat je ervoor betaald)
product				product
melkindustrie			milk industry
discussie			discussion
verklaring			explanation
grote schoonheid		great beauty
de aanval			the attack
slag, strijd			battle
uiterlijk, kijk, stijl		look (hoe je er altijd uitziet)
uiterlijk				appearance (hoe je er nu uitziet)
identiteit			identity
andere, verschillend(e)		different
verschil				difference
kracht				force, strength
kracht, macht, vermogen	power
voordeel			advantage, benefit
nadeel				disadvantage
uitdrukking, uiting		expression
belang, waarde			importance
persoonlijkheid			personality
karakter			character	
hoi				hi 
zin, zinnen			sentence, sentences, phrase, phrases	
beweging			motion, move, movement				
degradatie			demotion
gemeenschap			community
gemeenschappelijk		common
veel voorkomende zinnen	common phrases
oké				okay	
goedendag			good day
goed gedaan			nicely done
goed werk			nice job		
advertentie(s)			ad(s)	
pardon				excuse me
helaas				unfortunate, unfortunately	 
gelukkig			fortunate, fortunately	
verlengen 			to extend	
uitspreken			to pronounce
uitspraak (hoe je uitspreekt)	pronuciation
overwegen			to consider
toevoegen			to add
toevoeging			addition
toevoegen, meetellen		to include
rusten				to rest
praten, spreken		to talk, to speak
vertellen, zeggen		to tell, to say
nemen				to take
uittrekken			to take off
reizen				to travel
verschijnen			to appear, to show up
reserveren, boeken		to reserve
aankondigen			to announce
informeren			to inform
veranderen, verwisselen	to change
ontwikkelen			to develop
verlangen			to desire
aankomen, arriveren		to arrive
open laten			to leave open
beslaan, bedekken, dekken	to cover
omslag, bedekking		cover
ontdekken			to discover
actie ondernemen, handelen	to take action
herkennen			to recognize
voornemen, van plan zijn	to propose
zich voornemen		proposing
voorstel			proposal
veronderstellen/ervan uitgaan	to suppose (gebaseerd op eigen gegevens)                  
veronderstellen/ervan uitgaan	to assume (deels gebaseerd op feiten)
veronderstellen	/ervan uitgaan	to presume (gebaseerd op feiten)
aanname			assumption
bewegen, verplaatsen		to move
om door te gaan naar		to advance to
bevorderen			advance
trekken				to pull
duwen				to push
drukken			to press
hangen				to hang
dragen				to carry, to wear
optillen, tillen			to lift
voltooien, afmaken		to complete
interesseren			to interest
noemen, vermelden		to mention
melding, vermelding		mention
afhangen			to depend
eisen, vragen naar		to demand
vereisen			to require
bevelen	, bestellen		to order
bevelen				to command		
aanbevelen, aanraden		to recommend
aanraden			to advise
aanbeveling			recommendation
bepalen			to determine
bekijken, onderzoeken		to examine (observeren/inspecteren), to research (ijverig zoeken)
voorspellen			to predict, to forecast
voorspelbaar			predictable
onvoorspelbaar			unpredictable
voorspelling			prediction
aanmoedigen			to encourage
ontmoedigen			to discourage
moed				courage
aanduiden, duiden op		to denote
observeren			to observe
klinken				to sound
(over)blijven, resteren		to remain
stoffelijk overschot		remains
zich verontschuldigen		to apologize
beïnvloeden			to affect
bestaan			to exist (bestaan, zijn), to consist (toneelstuk bestaat uit 2 delen)
het bestaan			the existence
uitleggen			to explain
beschrijven			to describe
omschrijven			to define
abonneren			to subscribe
vermijden			to avoid
veroorloven			to afford
inspanning			effort
overgeven			to surrender
overgave			surrender
omringen			to surround
met pensioen gaan		to retire
met pensioen			retired
schuilen			to take shelter
verleiden			to tempt
verleiding			temptation
vernietigen, verwoesten	to destroy
vernietiging, verwoesting	destruction
vernietigbaar			destructible
onverwoestbaar		indestructible
zich verzetten tegen		to resist
weerstand bieden		to resist
het verzet, de weerstand	the resistance
lachen				to laugh
vieren				to celebrate
volgen				to track, to follow
doen alsof			to pretend
aansteken			to ignite
kwetsen, pijn doen		to hurt
spelen				to play	
knijpen				to squeeze
uitsterven			to extinct
zuigen				to suck
lasting vallen			to bother
spoken				to haunt
spijt hebben van, betreuren	to regret
worselen			to struggle
struikelen			to stumble
voorstellen, presenteren	to introduce
presenteren, voorleggen	to present
behoren			to belong	
verhogen,verlengen 		to increase
vermeerderen, toenemen	to increase
verminderen, afnemen		to decrease, to reduce
vestigen,oprichten,vaststellen	to establish
verbeteren			to improve
beter worden, terug krijgen	to recover
vergelijken			to compare
vervangen			to replace, to substitute
terugzetten			to replace
aandacht hebben, opletten	to pay attention
de aandacht			the attention
bewijzen			to prove
bewijs				evidence
bereiken			to achieve, to reach
van belang zijn			to matter
voorkomen			to prevent
opladen, in rekening brengen	to charge
schuld geven			to blame
koken				to boil
bijten				to bite
roeren				to stir
opofferen			to sacrifice
snijden/hakken			to cut/to chop
afwassen			to do the dishes
bakken				to bake, to fry
braden				to fry
leunen				to lean
lesgeven			to teach
opvoeden			to raise
slagen, passeren, voorbijgaan	to pass
pas, doorgang			pass
het verleden			the past
voorbij				past
falen, zakken			to fail
vroeger, gewend om		used to
vroeger				back in the days
mislukking, mislukkeling	failure
afstuderen			to graduate
afgestudeerd			graduated
bederven, vervuilen		to taint
bedorven liefde			tainted love
vervagen			to fade, fade away
vervaagd			faded
verliezen			to lose
kiezen				to choose, to pick
toepassen, solliciteren	 	to apply
aanvragen, gelden		to apply
meten				to measure
analyseren			to analyze
analyse				analysis
waarderen,schatten,taxeren	to value
waarderen			to appreciate
beheren, leiden, besturen	to manage
lukken, aankunnen		to manage
leiden				to lead
passen				to fit, to try on
kunnen				to can, to be able to
mogen				to may, to be allowed to 
moeten				to must, to need, have to, to shall
willen				to want
zullen				to will, to shall
hoeven				to need
zou willen			would
zou kunnen			could
zou moeten			should
voelen				to feel, felt, felt
vallen				to fall, fell, fallen 
donderen			to thunder
vriezen				to freeze
winderig			windy
blazen				to blow
spellen				to spel
vertalen			to translate
betekenen, bedoelen		to mean
laten vallen			to drop
terug vallen			to drop back
langzamer gaan, vertragen	to slow down
vertragen			to delay
blijven				to stay
staan 				to stand
houden, bewaren, blijven	to keep
vasthouden			to hold
krijgen, komen, worden	to get
snappen, begrijpen		to get
worden				to become, turn into
opslaan, bewaren		to store
verlichten, opluchten		to relieve
opgelucht			relieved
verpletteren			to crush
verzamelen			to gather (informatie verzamelen), to collect (verzameling munten)
verspillen			to waste
kopen				to buy
aankoop			purchase
verkopen 			to sell	
fietsen				to bike, to cycle
leggen, zetten			to lay, to put
neerleggen			lay down 
liggen				to lie, lay, lain
gaan liggen			lay down
liegen				to lie, lied, lied
leugen				lie
aan het liegen/liggen		lying
proeven, smaken		to taste 
ruiken				to smell
stinkende			smelly			
stinken				to stink
grijpen				to grab
verslaan			to beat, to defeat (formeler, bv. defeats in war) 	
verdienen			to earn (wel arbeid), to gain (geen arbeid), to deserve	
zoeken				to seek (item zoeken), to search (plaats waarin je zoekt), look for
scheiden			to divorce (echtscheiding), to separate (van tafel en bed)
afval scheiden			separating waste
wanhopig			desperate
wanhopig op zoek		desperate seeking
trouwen			to marry
vertrouwen			to trust
handelen, ruilen		to trade 
lenen				to lend (aan ander lenen), to borrow (van ander lenen)
oversteken			to cross
opschrijven			to write down
invullen				to fill in
tegenkomen			to run into, to encounter, to come across (geen persoon maar ding)
ontmoeting			encounter (ongeplande, onverwachte ontmoeting), meeting
vergadering			meeting
afspreken, overeenkomen	to agree on
eens zijn met			to agree with
vasthouden			to hold
meedoen, deelnemen		to participate, join
laten				to let
laten gaan			to let go
loslaten				to let go of
meenemen			to take along
ontmoeten			to meet
toestaan, toelaten		to allow
toegestaan(voltooid deelwrd)	allowed (past participle)
vastzitten			to be stuck
verraden			to betray
spuiten				to squirt
storen				to disturb	
samenwerken			to cooperate (hetzelfde doel), to collaborate (doel ander)
ophalen			to pick up
geloven				to believe
beloven				to promise
belofte				promise
dwingen			to force		
durven				to dare
beschermen			to protect
waarschuwen			to warn
ontspannen			to relax
stelen				to steal
plegen				to commit
repareren			to repair
in elkaar zetten, monteren	to assemble
opwinden			to excite
bang maken, schrik aanjagen	to frighten
fascineren			to fascinate
uitputten			to exhaust
motiveren			to motivate
beu zijn			to be fed up
stressen			to stress
beledigen			to insult
rechtvaardigen			to justify
bekennen			to confess
leven, wonen			to live
negeren			to ignore
vullen				to fill
invullen				to filling in
opvullen			to filling up
bidden				to pray
luisteren			to listen
fluisteren			to whisper
fluiten				to whistle
vechten			to fight
ontkennen, ontkenning		to deny, denial
teruggeven, terugkomen	to return
terugkeren			to return
antwoorden			to answer
antwoorden, reageren		to respond
Irriteren			to irritate
uitdagen			to challenge
zwijgen				to shut up
wijzen				to point
oppassen			to beware, to watch out
bezorgd zijn			to worry, to be concerned
besluiten			to decide
begrijpen			to understand
verkeerd begrijpen		to misunderstand
vertrekken			to leave, to depart
varen, zeilen			to sail
overtuigen			to convince
slapen				to sleep
blussen				to extinguish
haasten			to rush, to hurry
in verlegenheid brengen	to embarrass
uitwissen			to erase
gum				eraser
naderen			to approach
naderende komeet		approaching comet
scheren				to shave
delen				to share
haten				to hate
sturen				to send
beoordelen			to judge
veroordelen			to condemn
accepteren			to accept
ruzie maken			to argue
weergeven			to display
vliegen				to fly
knuffelen			to hug
tekenen			to draw, to sign (handtekening=signature zetten)
schilderen			to paint
ontspannen			to relax
klagen				to complain
verpesten			to screw up
bedriegen			to cheat
schreeuwen			to shout, to yell
gillen				to scream	
wandelen			to walk, to hike
liften				to hitchhike
parkeren			to park
ontwerpen			to design
bezoeken			to visit
toewijden			to devote (familie en geliefden), to dedicate (werk, enz)
toegewijd			devoted, dedicated
gooien				to throw
scoren				to score
schoppen			to kick
sporten	, oefenen		to exercise
staken				to strike
niezen				to sneeze
hoesten			to cough
sterven				to die
bloeden			to bleed
genezen			to cure (lichamelijk), to heal (geestelijk)
lijden				to suffer
verbergen			to hide
uitvoeren			to conduct
stromen			to flow
stroom				stream
drijven				to float
leveren				to deliver
verzenden			to ship
organiseren			to organize
verbeelden, zich voorstellen	to imagine
verbeelding			imagination
realiseren			to realize
rijden				to drive (vierwielers), to ride (tweewielers)
ontvangen			to receive
springen			to jump
groeien				to grow
poetsen			to brush
uitvinden			to invent
uitnodigen			to invite
verwachten			to expect
veroorzaken			to cause
verwijderen			to remove
oplossen			to solve, to resolve
betrekken, verwikkelen		to involve
(om)draaien, (om)wentelen	to revolve
draaien				to turn, to orbit (om de maan)
Twijfelen			to doubt, to hesitate
Verwarren			to confuse
Verward zijn			to be confused
Verwarring, verwardheid	confusion
verwarrend			confusing
weigeren			to refuse
afwijzen			to reject
scheuren			to tear
interesseren			to interest
raden				to guess
gast				guest
zich vergissen			to be mistaken
suggereren			to suggest
aankleden			to get dressed
zich afvragen			to wonder
vervelen			to bore
zich vervelen			to be bored
omvallen			to fall over
verrassen, verbazen		to surprise
zich verrassen/zich verbazen	surprised
ergeren				to annoy
zich ergeren aan		to be annoyed by
zich schamen			to be ashamed	
schaamte			shame
zich bevinden, gelegen zijn	to be located
lokaliseren			to locate
verheugen			to rejoice 
uitkijken naar			to look forward to
gedragen			to behave
gedrag				behavior
houding			attitude
dubbelzinnig			ambiguous
ambitie				ambition
degradatie			relegation
bovendien, verder		furthermore
vertraging			delay (zelfstandig naamwoord), delayed (BN)
geweldig			awesome, marvelous
fantastisch			fantastic
fascinerend, fascinerende	fascinating
vreselijk			terrible
doodsbang			terrified
afschuwelijk			awful, horrible
walgelijk, onsmakelijk		disgusting
belachelijk			ridiculous
lachwekkend			laughable
verbazingwekkend		amazing (gevoel van verrassing)
uitstekend 			excellent (hoge kwaliteit)
lekker, smaakvol		tasty
smaak				taste(5 basissmaken in mond),flavor (combinatie geur, smaak, enz)
pittig				spicy
geur, reuk			smell
verrukkelijk			delicious
vies				dirty 
goor				gross 
lelijk				ugly	
banaan				banana
tomaten			tomatoes
groenten			vegetables 
peper				pepper
honger				hunger
hongerig			hungry
eerste				first
dorst				thirst	
dorstig				thirsty
gratis proefperiode		free trial
gevoel van droogheid		sensation of dryness
keel				throat
nek				neck
verlangen naar vloeistoffen	craving for liquids
kat				cat		
koe				cow
konijn				rabbit
duif				pigeon
eekhoorn			squirrel
kikker				frog
muis				mouse
muizen				mice
schaap, schapen		sheep
goedkoop			cheap	
duur				expensive
hert				deer
lieve, beste			dear
varken				pig
gans				goose
spook				ghost
uil				owl
hoorn				horn
neushoorn			rhino, rhinoceros 
staart				tail
kleinhandel			retail
handel				trade
beurs				stock market
uitdaging			challenge
edelsteen			gem(stone)	
vaardigheid			skill
sokken				socks
trui				sweater
klomp				wooden shoe
klompen			clogs
ondergoed			underwear
bliksem				lightning
licht, lichte			light
zwaar, zware			heavy
klein				small, little
groot				large, big, great
kort				short
lang				long, tall
hoog				high
laag				low
vaak				often (lopende periode), frequently (bepaalde periode)
regelmatig			regularly
spoedig, vroeg			soon, early (eerder dan gewoonlijk)
zwak				weak
sterk				strong
zacht				soft
hard				hard	
makkelijk			easy
moeilijk			difficult, hard
moeilijker			harder
moeilijkste			hardest
nauwelijks			hardly (met moeite te bereiken), barely (t.o.v. het geheel)
ruig				rough
tough				taai
meer				more, anymore
minder				less (milk/ontelbaar), fewer (men/telbaar)
veel				a lot of, many, much
weinig				few, little
meer dan			for over, more than (vaak gevolgd door getal)
vers				fresh
zin(tuig), gevoel, betekenis	sense
proces 				trial
lichtelijk			slightly
aangenaam			pleasant
men				one, they
verschillende, verscheidende	various
alle, hele, helemaal, allemaal	all	
allerlei				all kinds of
enkele, een paar		a couple of, a few
enige, alleen			only
enkel				single
van haar			hers
van hem			his
mevrouw			madame, Mrs.
dame 				lady
meneer				Sir, Mister, Mr.
verwant aan			related to
familie, gezin			family
huisdier			pet
misschien			maybe, might be, perhaps
bij ons				with us
tenzij				unless
tot, totdat			until
voor, voordat			before
onder				under, beneath/ underneath (covered), below (same building, etc)
boven				above
omlaag, naar beneden		down, downwards
omhoog, naar boven		up, upwards
beneden			downstairs
bodem, onderkant		bottom
binnen				inside, within
binnen een week		within a week
buiten				outside
voor				in front of
achter				behind
rechtdoor			straight ahead
vooruit				forward, ahead
achteruit			backward (US), backwards (UK)
opzij				aside
daarna				afterwards
daardoor, daarom		therefore
ondanks			despite
volgens				according to
of				or, whether (wordt gebruikt bij keuze of alternatief)	
alsof				as if
in plaats van			instead of, rather than
door middel van		by means of
in tegenstelling tot		unlike				
onwaarschijnlijk		unlikely
waarschijnlijk			probably
voorbij, verder dan		beyond
midden op, midden in		in the middle
dankzij				thanks to
vanwege			because of
sinds				since
overheen, dwars over		across
aan de overkant		across
tegenover			across from
vanaf vandaag			from today on, starting today
tot en met			to, up to and including	
dicht bij, vlak bij		close to, near
naast				beside, next to
tussen				between
tussen in			in between	
snel				fast (use by speed), quick, quickly (both use by time)
om, rond, rondom		around
rotonde				roundabout
voorzichtig, zorgvuldig		carefull, carefully
onvoorzichtig, onzorgvuldig	careless
genaamd			called
nul				zero
laatste				last
hoewel, ondanks dat		although, though, even though (geeft meer nadruk)
beroemd			famous
beroemdheid			celebrity
vieren				to celebrate
berucht				notorious
deken 				blanket
ontvoering			abduction
eigendom, landgoed		property, estate (bevat ook eigendomsrechten, enz)
windmolen			windmill
geluid				sound (wanted), noise (unwanted)
stem				voice, vote
goed				good, well, correct, correctly
verkeerd			wrong, incorrect, incorrectly
opeens, ineens, plotseling	suddenly
meteen, onmiddellijk, direct	immediately, right away, straightaway
plezierig, aangenaam, prettig	enjoyable
omstandigheid			circumstance
omstandigheden 		circumstances
situatie				situation
klemtoon, nadruk		emphasis
indrukwekkend			impressive
onder de indruk		impressed (bijvoeglijk naamwoord)
terwijl				while, whereas, as 
beleefd				polite
hoofdletters			capitalization	
dief				thief
in principe			basicly	
parfum				perfume
potlood				pencil
werkgever			employer	
werknemer			employee
arbeider			worker
piloot				pilot
slager				butcher
slagerij				butcher shop, butchery
dierenarts			veterinarian
bakker				baker
bakkerij			bakery	
slot				lock
op slot				locked (bijvoeglijk naamwoord)
woonkamer			living room
slaapkamer			bedroom
kast				closet
kastje				cabinet, cupboard
lade				drawer
meubels			furniture
bank				couch, sofa
gordijn				curtain
zeker				sure, secure, certain (is formeler), certainly
zekerheid			certainty
bepaalde feiten			certain facts
onzeker			unsure, insecure (gevoel van onzekerheid), uncertain (twijfel)
feit				fact
kussen				pillow
tapijt				carpet
bezem				broom
bruid				bride
bruidegom			groom
magnetron			microwave
koelkast			refrigerator, friger, fridge
diepvries, vriezer		freezer
vaatwasser			dishwasher
wasmachine			washing machine
droger				dryer
strijkijzer			flatiron
stofzuiger			vacuum cleaner, hoover 
was				loundry
vaat				dishes
gerecht				dish
stofdoek			duster
vuilnis, afval			trash (banden), garbage (afval uit keuken/badkamer)
afval				rubbish (Brits)
vuilnisbak			trash can, garbage bin	
vuilnisbak binnen		rubbish bin 
bak				bin
haren				hair
voet, voeten			foot, feet
huid				skin
gezicht				face
tand, tanden			tooth, teeth
teen/tenen			toe/toes
botten				bones
schouder			shoulder
buik				belly
knie				knee
maag				stomach, tummy (kindertaal)
lever, nier, long		liver, kidney, lung
kaak				jaw
puistje				pimple
traan 				tear
adem				breath
moedig, dapper		brave
moed 				courage
trots				proud
zenuw				nerve
bijgeloof			superstition
verdacht (bijvoeglijk nw)	suspicious
verdachte			suspect
dollar				dollar, bucks (bok)
duizend dollar			grand
hoeveel keer			how many times
zes keer drie			six times three	
logisch, zintuig, gevoel		sence
logisch				logical
vrolijk				jolly, cheerful (zichtbaar gelukkig)
blij				happy, glad (vaak wordt de reden erbij gezegd)
geluk				happiness
heel goed			jolly good
vriend				pal, friend
maat				mate
vent				fellow
jongens			felles
broer				bro
kerel				guy, dude
collega				colleague
onderhoud			maintenance
netjes				tidy
verliefd				in love
verloofd			engaged
verloofde			fiancé
getrouwd			married 
gescheiden 			divorced, separated
huwelijk			marriage
bruiloft				wedding
pa en ma			dad and mom
opa en oma			grandpa and grandma
vader en moeder		father and mother
grootvader, grootmoeder	grandfather, grandmother
ouders				parents
grootouders			grandparents
kleinzoon/kleindochter		grandson, granddaughter
kleinkind(eren)			grandchild, grandchildren
neef				cousin (zoon oom), nephew (zoon broer)
nicht				cousin (dochter oom), niece (dochter broer)
mannelijk en vrouwelijk	male and female
stamboom			family tree
stiefvader, stiefmoeder		stepfather, stepmother
schoonzus			sister-in-law
zwager				brother-in-law
halfzus/halfbroer		half sister/half brother
schoonvader, schoonmoeder	father-in-law, mother-in-law 
schoonzoon, schoondochter	son-in-law, daughter-in-law
winkel				shop (UK), store (VS)
winkelcentrum			shopping mall
verkoop, uitverkoop		sale
te koop				for sale	
supermarkt			supermarket
kleren/kleding			clothes/clothing
kledingzaak			clothing store
vrouwenkleding		women’s clothing
winkelwagen			shopping cart
boodschappen doen		to buy groceries
balie				counter
kassa				checkout counter
korting				discount
procent				percent
paskamer			fitting room
passende muziek		fitting music	
warenhuis			department store
magazijn, pakhuis		warehouse
bon				receipt
contant				cash
pinpas/creditcard		debit card/credit card
letterlijk			literal, literally
figuurlijk			figuratively
strak, schaars			tight
waarschuwing			warning
schade				damage
gewond				hurt (geestelijk),wounded (wondje),injured(lichamelijk letsel)
wond				wound
noodgeval			emergency
ramp				disaster
bezorgd			concerned (bezorgdheid tonen), worried (zorgen maken)
verlegen			shy
jaloers				jealous
verrast				surprised
koppig				stubborn
saai				boring
verveeld			bored
voorzichtig			careful
gevaar				danger
gevaarlijk			dangerous
schattig			cute
raar				weird (verbonden met lot dat beïnvloedbaar is) , strange
stom				stupid
gek				crazy, silly (dwaas, verdient medelijden), mad (geestelijk gestoord)
boos				angry, mad
slim				clever(vindingrijkheid), smart(intelligentie), intelligent
verstandig			sensible (waarneembaar met zintuigen), wise
ingewikkeld			complicated
stout				naughty
schitterend			splendid
zwembroek			swimming trunks, swimsuit (korter model, vaak dames)
hoofdkantoor			headquarters (gebouw), main office (kamer)
achtertuin			backyard
stadhuis			city hall
woonplaats			place of residence
zitplaats			seat
brandweerman			fireman, firefighter (kan ook vrouw zijn)
brandweerauto			fire truck
brandblusser			fire extinguisher
huurauto			rental car
luisterboek			audiobook
vogelhuis			birdhouse
meer/meren			lake, lakes
woestijn			desert
steen, rots			stone, rock
kanaal				canal (water), 
kanaal, zender			chanal
huisje				cottage
pijl				arrow
jammer				a pity
inderdaad			indeed
eet smakelijk			enioy your meal
tot ziens			see you, so long, goodbye
groeten, groetjes		regards, greetings
met vriendelijke groeten	kind regards 
hoogachtend			yours sincerely (heel zakelijk en formeel)
aangenaam			pleasant
vriendelijk			friendly, kind
hoera				hurray
veel plezier			have fun
oprecht, van harte		sincere, sincerely
kort, even			briefly
eigenlijk			actually
precies				exactly
werkelijkheid			reality
trouwens			by the way
van streek			upset
ziek				sick, ill
ziekte				disease, illness, sickness
ramp				disaster
griep				flu
koorts				fever
gezondheid			health
gezond				healthy
de gezondheidszorg		healthcare
verpleegkundige		nurse
ongeluk			accident
behandeling			treatment
afspraak			appointment
allergisch			allergic
geneesmiddel			medication, drug	
zalf				ointment
toestand			condition
rolstoel				wheelchair
pleister				band aid (US), plaster (UK)
verband			bandage
wond				wound
salade				salad
frisdrank			soda, soft drink
pindakaas			peanut butter
taart				cake, pie
snoep				candy
koekje				cookie
gebak				pastry
pannenkoek			pancake
slagroom			whipped cream
zoet				sweet
zuur				sour
bitter				bitter
pittig				spicy
hartig				savory
citroen				lemon
limoen				lime	
peer				pear
druif, druiven			grape, grapes
kers, kersen			cherry, cherries
bes, bessen			berry, berries
braam				blackberry
noot 				nut
rijp				ripe
ui				onion
aardappel			potato
champignon			mushroom
bloemkool			cauliflower
paprika				bell pepper
boon, bonen			bean, beans
worst				sausage
rundvlees			beef
biefstuk			steak
knoflook			garlic
gehaktbal			meatball
gehaktbrood			meatloaf
gehakt				ground meat, minced meat, mince
spek				bacon
kastje				cupboard
vlucht				flight
aankomst			arrival
vertrek				departure
bagage				luggage
gids				guide
vliegtuig			airplane
vakantie			holiday (UK), vacation (US)
zeilboot				sailboat
veerboot			ferry
ambassade			embassy
bezienswaardigheid		sight
scheerapparaat			shaver
scheermes			razor
volwassene			adult
bejaard				elderly
bleek				pale
helder				bright
plafond				ceiling
dienblad			tray
sterfelijk, onsterfelijk		mortal, immortal
eeuwig				eternal
eeuwigheid			eternity
voor eeuwig			eternally
bad/badkuip			bath/bathtub
badkamer			bathroom
wc				toilet, bathroom
zwembad			pool, swimming pool
douche				shower
kraan				faucet, crane
handdoek			towel
gootsteen			sink
borstel				brush
zeep				soap
lippenstift			lipstick
zakdoek			handkerchief (stof), tissue (papier)
probleem, kwestie		issue
emmer				bucket
natuur				nature
grond				soil
vulkaan				volcano
regenwoud			rainforest
grot				cave
kloof				gorge
gletsjer				glacier
heet				hot
hitte				heat
koud, kou			cold
leeg				empty
vol				full
brandstof			fuel
milieu				environment
ijs				ice, ice cream
elektriciteit			electricity
allergisch			allergic
tram				tram
rijbewijs			driver’s license
vrachtwagen			lorry (UK), truck (US)
automobilist, bestuurder	(car) driver, motorist
bestuurdersstoel		driver’s seat
bijrijdersstoel			passenger seat
achterbank			back seat
fietser				cyclist, bicyclist
stoep				sidewalk
voetganger			pedestrian
fietspad			bike path
wandelaar			walker (lage frequentie) , hiker (fanatieker)
lifter				hitchhiker
lantaarnpaal			lamppost
openbaar vervoer		public transportation
verkeer				traffic
stoplicht			traffic light
verkeersbord			traffic sign
file				traffic jam
informatie			information
verkeersinformatie		traffic report
zebrapad			crosswalk
kruispunt			intersection, crossing (weg doorkruist met zebrapad of iets anders)
voorrang			right of way
snelweg			highway
weg				road
haast, spoed			rush, hurry
tankstation			gas station
spits				rush hour
opstanding			resurrection
opstand			insurrection
richtingaanwijzer		turn signal
post				mail
gesprek			conversation
bericht				message
sms				tekst message
ruzie				disagreement, quarrel
ruzie maken			to argue
lift				elevator
verdieping			floor
trap				stairs, stairway
balkon				balcony
gang				hallway
ingang				entrance fysieke ingang), entry (fysieke ingang, toegang, komst)
kelder				basement, cellar (voor opslag wijn, enz)
verwarming			heater (één ding), heating (meerdere dingen, zoals CV)
radiator			radiator
zolder				attic
begane grond			ground floor (UK), first floor (US)
eerste verdieping		first floor (UK), second floor (US)
toneelstuk			play
pretpark			amusement park
oven				oven
fornuis				stove
hap				bite
chocolade			chocolate
toetje				dessert
woestijn			desert
kruid/kruiden			herb/herbs
specerij/specerijen		spice/spices
ingrediënt/ingrediënten	ingredient/ingredients
gerecht				dish
hoofdgerecht			main course, main dish
voorgerecht			starter (UK), appetizer (US)
recept				recipe
saus				sauce
rauw				raw (niet gebakken), rare (licht gebakken)
gaar				done
kookboek			cookbook
kom				bowl
aanrecht			countertop
deksel				lid
snijplank			cutting board
bestek				utensils (keukengerei), cutlery (messen, vorken en lepels)
bord, mes, vork, lepel		plate, knife, fork, spoon
goud				gold
zilver				silver
brons				bronze
saffier				sapphire (blauw)
robijn				ruby (rood)
smaragd			emerald (groen)
amethist			amethyst (paars)
parel				pearl (wit/roze, zwart)
obsidiaan			obsidian (zwart) 
diamant			diamond (kleurloos of gele kleurtint)
metaal, ijzer, staal		metal, iron, steel
hout, beton, baksteen, klei	wood, concrete, brick, clay
wol, katoen, zijde, leer, stof	wool, cotton, silk, leather, fabric
karton				cardboard
lijm, plakband			glue, tape
krijt, krijtje, schoolbord	chalk, piece of chalk, blackboard
materiaal			material
onderwijs, opleiding		education
les				class, lesson
toets				test
oefening			practice, exercise
huiswerk			homework
opdracht			assignment, order, task
huiswerkopdracht		homework assignment
cijfer, klas, graad		grade
klas				class
examen			exam
kennis				knowledge
schrift				notebook
speeltuin			playground
kleuterschool			kindergarten	
basisschool			primary school (UK), elementary or grade school (US)
middelbare school		secondary school
opvoeding			upbringing
uitleg				explanation
presentatie			presentation
voorbereiding			preparation
voorspelling			prediction, forecast
weer				weather
weersvoorspelling		weather forecast
weerbericht			weather report	
nat				wet
storm				storm
wolk				cloud
bewolkt				cloudy
vochtig				humid
zonnig				sunny
sneeuw				snow
hagel				hail
regenbui			rain shower
regenboog			rainbow
temperatuur			temperature
graden				degrees
donder				thunder
onweer				thunderstorm
donderslag, verbaasd		thunderstruck
bliksem				lightning
blikseminslag			lightning strike
orkaan				hurricane
overstroming			flood
woordenboek			dictionary
vertaling			translation
alinea				paragraph
pagina				page
hoofdstuk			chapter
apparaat			device
stekker				plug
stopcontact			power outlet, socket (ook waar je een lamp indraait)
knop				button
luidspreker			speaker
draadloos			wireless
toetsenbord			keyboard
laptop/computer		laptop, computer
kabel				cable
beeldscherm			screen
bureau				desk
handleiding			manual
schroef				screw
onderdeel			part, component (zelfstandig deel van groter ding)
liniaal				ruler
tekenaar			drawer
tekening			drawing
schilder				painter
penseel, kwast			paintbrush
verf				paint
doek				canvas
tentoonstelling			exhibition
kaartje				ticket
portret				portrait
schets				sketch
beeldhouwer			sculptor
standbeeld			statue
vrijheidsbeeld			statue of liberty
vrijheid				freedom (ontstaat uit menselijkheid), liberty (politiek)
vrede				peace
voor de hand liggend		obvious
vanzelfsprekend, duidelijk	obvious
kennelijk, duidelijk		obviously (voor de hand liggend)
blijkbaar			apparently, evidently
schijnbaar			seemingly
gebeurtenis, evenement	event
gelegenheid			occasion
eindelijk			finally
uiteindelijke/uiteindelijk	eventual (BN), eventually BW)
driehoek			triangle
vierkant			square
cirkel				circle
vorm				shape
gat				hole
recht				straight
kromme, gebogen		curved
dun				thin
mager				skinny
dik				fat (bovenlichaam/ronde buik), thick (onderlichaam en trui e.d.)
spier, gespierd			muscle, muscular
breed				wide (fysiek), broad (figuurlijk)
plat				flat
smal				narrow
bovenkant			top, upside
onderkant			bottom, underside (wat onder de bottom zit)
voorkant			front
achterkant			back
overkant			other side
achterstevoren			backwards
terugspoelen			rewind
binnenstebuiten		inside out
ondersteboven			upside down
binnenkant, buitenkant		inside, outside
artikel				article
verbinding			connection
netwerk			network
uitzending			broadcast
omroep				broadcaster
aflevering			episode
levering			delivery
verzending			shipment
uitnodiging			invitation
samenvatting			summary
achter elkaar			one after the other
wachtwoord			password
bestand			file
bevestiging			confirmation
universum			universe
zonnestelsel			Solar System
Melkweg			Milky Way
sterrenstelsel			galaxy
atmosfeer			atmosphere
telescoop			telescope
satelliet				satellite
asteroïde			asteroid
ruimteschip			spaceship
aards				terrestrial
buitenaards			extraterrestrial
buitenaards wezen		alien
baan				orbit
raket				rocket
intussen, in de tussentijd	meanwhile (vaak bijwoord), meantime (vaak Zelfst. Nw)
schande			shame, disgrace
schandalig			disgraceful
geloofwaardig			credible
ongelooflijk			incredible
zonsondergang			sunset
zonsopkomst			sunrise
noord, oost, zuid, west		north, east, south, west
ten westen, enz		west of, enz
naar het westen, enz		to the west, enz
noordelijk, oostelijk		northern, eastern
zuidelijk, westelijk		southern, western
noordelijke, oostelijke		northerly, easterly
zuidelijke, westelijke		southerly, westerly
halfrond			hemisphere
hoofdstad			capital
dialect				dialect
vanzelf, automatisch		automatically (BW)
automatische			automatic (bijv. nw)
aan de andere kant		on the other hand
voorlopig			for now (nu nog wel), for the time being (zolang niets veranderd)
tijdelijk				temporary (BNW), temporarily (BW)
temporiseren			to temporize
stiekem			secretly
geheim				secret
voldoende			sufficient(ly), enough
pas op 				beware of, watch out
vervelende			annoying
gewoonte			habit
verfrissend			refreshing
het leven			life
wonen				live
de dood			the death
levende	 spin			living spider
verrassend nieuws		surprising news
zanger, zangeres		singer
publiek				audience, public
acteur, actrice			actor, actress
toeschouwer			spectator
podium, stadium, fase		stage
literatuur			literature
roman				novel
mode				fashion
afbeelding			image
foto				photo, picture
figuur				figure
grafiek				graph (diagram), graphics (ontwerptekening)
gedicht				poem
middenvouw			center fold
keuze				option, choice (Options are the things and choices are our decision)
zeldzaam			rare
mogelijk			possible, possibly
onmogelijk			impossible
mogelijkheid			possibility
kans				chance, opportunity
verandering			change
oplossing			solution
herinnering			memory, reminder
geduldig			patient (BN)
het geduld			the patience (ZN)
verbeelding			imagination
gedachte/gedachten		thought (een vorm die in de geest (=mind) is gecreëerd)/thoughts
gedachten			mind (het vermogen tot rationeel denken)
verstand			mind (verm. tot rationeel denken), sense (hoe neem je iets waar)
gezond verstand		common sense
humor				humor, sense of humor
geheugen			memory
motivatie			motivation
bewuste keuze			deliberate choice
bewust gekozen		deliberately chosen
bewust van het gevaar		aware of the danger
eigenschap			quality, characteristic, trait (persoonseigenschap)
manier				way
voorkeur			preference
uitzondering			exception
uitzonderlijke, bijzondere	exceptional
gewoon, normaal		ordinary
buitengewoon			extraordinary
zelfbeheersing			self-control
eerlijk				honest
eerlijkheid			honesty
mening				opinion
argument			argument
standpunt			point of view, position
recensie			review
onredelijk			unreasonable
kritiek				criticism
kritisch				critical (ZN), critically (BW)
oordeel				judgment, verdict
genot, verrukking, vreugde	delight
opmerkelijk, merkwaardig	remarkable
onopmerkelijk/onmerkwaardig	unremarkable
begrepen			copy that
moeilijkheid, moeite		trouble, difficulty
verwacht, onverwacht		expected, unexpected			
verwachting			expectation
bestelling			order
hopelijk			hopefully
hopeloos			hopeless (BN), hopelessly (BW)
sprakeloos			speechless
stapel				pile
eindig				finite
eindeloos			endless, infinite
aanmelding, toepassing	application
aanmelding, ingang		entry
toegang			access	
sollicitatie			apply
lezing, college			lecture
universiteit			university, college
college				college
programma			program
rechter, advocaat		judge, lawyer
scriptie, proefschrift		thesis
instituut			institute
doof, blind			deaf, blind
giftig, giftige appel		poison, poisonous apple
duizelig				dizzy
dodelijk			deadly, lethal
pijn				pain, ache
buikpijn			bellyache, stomach ache
hoofdpijn			headache
opgezwollen			swollen
apotheek			pharmacy
apotheker			pharmacist
huisarts			family doctor, general practitioner
zwanger			pregnant
tandarts			dentist
drogisterij			drugstore
hulp, eerste hulp		aid, first aid
verslaafd, verslaving		addicted, addiction
ongesteld, periode		period
depressief			depressed, blue
dronken			drunk
vloeiend			fluent
kaal				bald
blond				blonde
veter				lace
prachtig			gorgeous
magnifiek			magnificent
knap (uiterlijk)			handsome (man), good looking (man en vrouw)
rits, knoop			zipper, button
zonnebril			sunglasses
koptelefoon			headphones
oortjes				earphones, earbuds
wimper				eyelash
wenkbrauw			eyebrow
armband			bracelet
ketting				chain
ring				ring
litteken				scar
tatoeage			tattoo
moedervlek			birthmark
muts				knit cap
breien				to knit
handschoen			glove
want				mitten
sieraad, juweel			jewel, jewelry(meervoud)
experiment			experiment
theorie				theory
met succes			successfully
glad, vlot			smooth
gladjanus			smooth operator
concept				concept
conclusie			conclusion
armoede			poverty
welzijn, welvaart		welfare, prosperity
chaos				chaos
vooruitgang, voortgang	progress
inwoner			resident, citizen
burger				citizen, civilian
beschaving			civilization
handtekening			signature
ontwikkeling			development
verzekering			insurance
zorgverzekering		health insurance	
klant				customer
slaapliedje			lullaby
risico				risk
boekhouding			accounting
zakenreis			business trip
relatie				relationship
romantisch			romantic
passie				passion
aantrekkelijk			attractive
liefdesverdriet			love sickness, heartbreak
gebroken hart			broken heart
teleurstelling			disappointment			
teleurgesteld			disappointed
geïrriteerd			irritated
opgewonden			excited
ongerust			anxious
kwetsbaar, onkwetsbaar	vulnerable, invulnerable
nieuwsgierig			curious
gezichtsuitdrukking		facial expression
zenuwachtig			nervous
hulpeloos			helpless
ademloos			breathless
tevreden, tevredenheid		satisfied, satisfaction
ontevreden			dissatisfied
gezellig, knus			cozy
regering			government
parlement			parliament
premier				prime minister
staat				state
koninkrijk			kingdom
voorzitter			chairman
verplicht			mandatory, obligatory
schuldig			guilty
onschuldig			innocent
rechtvaardigheid		justice
snelheid			speed
afstand				distance
massa				mass
lichtsnelheid			speed of light
microscoop			microscope
chemicaliën			chemicals
energie				energy
waar				true 
waarheid			truth
echt, werkelijk			truly
oppervlakte			surface
klimaat				climate
magneet			magnet
actie, daad, handeling		action
reactie				reaction
bekentenis			confession
ellende				misery
mysterie			mystery
gastvrijheid			hospitality
invloed				influence
opwinding			excitement
medelijden			compassion
geen genade			no mercy
verbetering			improvement
wijsheid			wisdom
symbool			symbol
gestrest			stressed, stressed out
winst				profit
verlies				loss
investering			investment
lening				loan
inkomen			income
fabrikant			manufacturer
uitgave(n)			expense(s)
failliet				bankrupt
campagne			campaign
strategie			strategy
factuur				invoice
aflossing			redemption
regel				rule
kandidaat			candidate
besluit				decision
vijand				enemy
veiligheid			safety, security
leger				army
wapen				weapon
priester, priesteres		priest, priestess
geest				ghost
lichaam en ziel			body and soul
bestemming			destiny (persoon of ding bestemming), destination
jood, joods			jew, jewish
christen			christian
engel				angel
begrafenis			funeral
heilig				holy, sacred
verboden			forbidden
levensbeschouwing		outlook on life
kerk				church
magie				magic
zorgeloos gefluister		careless whisper
menigte			crowd
kroon				crown
klaar voor de start, af		ready Set Go
zaklamp			flashlight
ridder				knight
lid				member
keizer, keizerrijk		emperor, empire
oudejaarsavond		New Year’s Eve
Kerstmis, Pasen		Christmas, Easter
Pinksteren, Hemelvaartsdag	Pentecost, Ascension Day
traditie				tradition
vuurtoren			lighthouse
premiejager			bounty hunter
huurmoordenaar		sicario
klootzak			scumbag
waardigheid			dignity
per ongeluk, onopzettelijk	accidental, accidentally
toevallig			accidental, accidentally
isolatie, isolering		isolation (wie/wat is geïsoleerd), insulation (waarvan geïsoleerd)
geïsoleerd			isolated, insulated
isolatie zoals piepschuim	insulation
getuige				witness
getuigenis			testimony
lapje				patch
kaskraker			blockbuster
onderhandelaar		negotiator
egoïstisch			selfish
roerei				scrambled eggs
gekookt ei			boiled egg
gebakken ei			fried egg
haver, havermout		oat, oatmeal
vooroordeel			prejudice, bias (minder extreem dan prejudice)
bevooroordeeld			prejudiced, biased
schuilplaats			shelter
water voorraad			water supply
energiecentrale			power plant
plaatsvervanger		deputy
minderwaardig			inferior
